33333333
32221113
32111223
32112223
33333333